1111111111111111111
1000000111100000001
10111001111010101C1
1010000000001010001
1010111100111110111
101110000000111P111
10111C00000C1111111
1E11111111111111111
1111111111111111111