1111111111111
1C000000000C1
110P011111001
10C011E000001
1111111111111