11111111111111111111111111
1P1111111111111111111111E1
11111111111111111111111111
11111011000100110100011111
11111011010101010101111111
11111011010100110100011111
11111011010101010111011111
11111001000101010100011111
11111111111111111111111111
1C1111111111111111111111C1
11111111111111111111111111