111111111111111
1P00000000C0001
111111111111101
1E0000000000001
111111111111111